Month;FEM;BMW;COMP;ADMIN;SUM
Jan;7;0;4;9;20
Febr;4;0;0;6;10
Márc;1;0;0;1;2
Ápr;1;1;0;2;4
Máj;3;0;2;3;8
Jún;3;5;8;6;22
Júl;10;18;10;12;50
Aug;31;16;8;17;72
Szept;13;8;4;0;25
Okt;3;3;1;3;10
Nov;0;3;4;0;7
Dec;35;30;24;15;104
Unplanned;44;12;24;17;97
